11111111111111111111111111111111111111111111111111
1P010000000000000010100000000000000110001000010001
10011000101111000000000000000110010100000001000001
10101000100010100000001000110100000001000011010101
10000000000100001100111101111100010100000001000001
10001010001000000000100010000110100010001000000001
10011001000001100010100011010000001000C01011000101
11010100001010000010000001000011000010001001000001
1C000011001001011100010100010110100000100101000011
11101011100000101000001001101011011001000101000011
10001001100110000010010110001100011010011001100001
10000001001010000011000000100010000001001111010011
10100001100100000110010010010011110100001100011001
11001010000000001000110011110100000000100001000011
10000100000010000011100000100001000101011011100001
10000000101100100000000100100111110000010000101011
10110011000001001001000000110100100001110100100001
10000100000100000001010110110001100000010000000011
10100000000000000001110100010110011100000000000001
10000000000000101100100011010000001011000000001001
100001000101000100C1000010100101100010100001100101
11100000000110010100010010010010000000010100101001
11000100110000000000100101000100000000111010000101
10011010100010001101101101000000000000000100011011
10011000101010101010000011001000010011010000111101
10011011000001100000000100000100000001000010011101
10000001000000101101100100000100001000000100000001
11010010010000111001100011001100001101010100001011
1000000000C001000010C000000010110001101000010010E1
11111111111111111111111111111111111111111111111111
